Species	PFT	Original names
Aloe aageodonta	'{'pft': 'not assigned ()', 'originalNames': ['Aloe aageodonta']}'
Papuechites aambe	'{'pft': 'not assigned ()', 'originalNames': ['Papuechites aambe']}'
Musa textilis	'{'pft': 'not assigned ()', 'originalNames': ['Musa abaca']}'
Caroxylon abarghuense	'{'pft': 'not assigned ()', 'originalNames': ['Salsola abarghuensis']}'
Didymosalpinx abbeokutae	'{'pft': 'not assigned ()', 'originalNames': ['Gardenia abbeokutae']}'
Psoralea abbottii	'{'pft': 'not assigned (legume?)', 'originalNames': ['Psoralea abbottii']}'
Cassia abbreviata	'{'pft': 'not assigned (tree)', 'originalNames': ['Cassia abbreviata']}'
Crotalaria abbreviata	'{'pft': 'legume', 'originalNames': ['Crotalaria abbreviata']}'
Miconia abbreviata	'{'pft': 'not assigned ()', 'originalNames': ['Miconia abbreviata']}'
Corymbia abbreviata	'{'pft': 'not assigned (tree)', 'originalNames': ['Eucalyptus abbreviata']}'
Diuris abbreviata	'{'pft': 'forb', 'originalNames': ['Diuris abbreviata']}'
Ecclinusa ramiflora	'{'pft': 'not assigned (tree)', 'originalNames': ['Ecclinusa abbreviata', 'Ecclinusa abreviata']}'
Sesamum abbreviatum	'{'pft': 'not assigned ()', 'originalNames': ['Sesamum abbreviatum']}'
Piper abbreviatum	'{'pft': 'not assigned ()', 'originalNames': ['Piper abbreviatum']}'
Sonchus congestus	'{'pft': 'not assigned ()', 'originalNames': ['Sonchus abbreviatus']}'
Helleborus orientalis	'{'pft': 'forb', 'originalNames': ['Helleborus abchasicus']}'
Homalium abdessammadii	'{'pft': 'not assigned (tree)', 'originalNames': ['Homalium abdessammadii']}'
Eucalyptus abdita	'{'pft': 'not assigned (tree)', 'originalNames': ['Eucalyptus abdita']}'
Zelkova abelicea	'{'pft': 'not assigned ()', 'originalNames': ['Zelkova abelicea']}'
Abelmoschus moschatus	'{'pft': 'not assigned ()', 'originalNames': ['Hibiscus abelmoschus']}'
Lithocarpus havilandii	'{'pft': 'not assigned ()', 'originalNames': ['Quercus abendanonii']}'
Bergenia	'{'pft': 'forb', 'originalNames': ['Bergenia abendglut']}'
Cyphostemma abercornense	'{'pft': 'forb', 'originalNames': ['Cyphostemma abercornense']}'
Oxalis abercornensis	'{'pft': 'forb', 'originalNames': ['Oxalis abercornensis']}'
Corymbia abergiana	'{'pft': 'not assigned (tree)', 'originalNames': ['Corymbia abergiana']}'
Guatteria aberrans	'{'pft': 'not assigned ()', 'originalNames': ['Guatteria aberrans']}'
Sloanea aberrans	'{'pft': 'not assigned (tree)', 'originalNames': ['Sloanea aberrans']}'
Habenaria aberrans	'{'pft': 'forb', 'originalNames': ['Habenaria aberrans']}'
Satyrium aberrans	'{'pft': 'forb', 'originalNames': ['Satyrium aberrans']}'
Picea abies	'{'pft': 'not assigned (tree)', 'originalNames': ['Picea abies']}'
Chusquea abietifolia	'{'pft': 'grass', 'originalNames': ['Chusquea abietifolia']}'
Erica abietina	'{'pft': 'not assigned ()', 'originalNames': ['Erica abietina']}'
Rosa abietina	'{'pft': 'not assigned ()', 'originalNames': ['Rosa abietina']}'
Helichrysum abietinum	'{'pft': 'not assigned ()', 'originalNames': ['Helichrysum abietinum']}'
Rubus abietinus	'{'pft': 'not assigned ()', 'originalNames': ['Rubus abietinus']}'
Digitaria abludens	'{'pft': 'grass', 'originalNames': ['Digitaria abludens']}'
Phyllanthus abnormis	'{'pft': 'forb', 'originalNames': ['Phyllanthus abnormis']}'
Aristida abnormis	'{'pft': 'grass', 'originalNames': ['Aristida abnormis']}'
Calamagrostis abnormis	'{'pft': 'grass', 'originalNames': ['Calamagrostis abnormis']}'
Millettia aboensis	'{'pft': 'not assigned (legume?)', 'originalNames': ['Millettia aboensis']}'
Elymus abolinii	'{'pft': 'grass', 'originalNames': ['Elymus abolinii']}'
Astragalus aboriginum	'{'pft': 'not assigned (legume?)', 'originalNames': ['Astragalus aboriginum']}'
Bulbostylis abortiva	'{'pft': 'grass', 'originalNames': ['Bulbostylis abortiva']}'
Eragrostis abortiva	'{'pft': 'grass', 'originalNames': ['Heterachne abortiva', 'Heterachne abortivum']}'
Epilobium abortivum	'{'pft': 'not assigned ()', 'originalNames': ['Epilobium abortivum']}'
Limodorum abortivum	'{'pft': 'forb', 'originalNames': ['Limodorum abortivum']}'
Ranunculus abortivus	'{'pft': 'forb', 'originalNames': ['Ranunculus abortivus']}'
Dalbergia abrahamii	'{'pft': 'not assigned (legume?)', 'originalNames': ['Dalbergia abrahamii']}'
Leptolaena abrahamii	'{'pft': 'not assigned (shrub/tree)', 'originalNames': ['Leptolaena abrahamii']}'
Nesogordonia abrahamii	'{'pft': 'not assigned ()', 'originalNames': ['Nesogordonia abrahamii']}'
Adenanthera abrosperma	'{'pft': 'not assigned (tree)', 'originalNames': ['Adenanthera abrosperma']}'
Pelargonium abrotanifolium	'{'pft': 'not assigned ()', 'originalNames': ['Pelargonium abrotanifolium']}'
Euryops abrotanifolius	'{'pft': 'not assigned ()', 'originalNames': ['Euryops abrotanifolius']}'
Senecio abrotanifolius	'{'pft': 'forb', 'originalNames': ['Senecio abrotanifolius']}'
Berzelia abrotanoides	'{'pft': 'not assigned (shrub)', 'originalNames': ['Berzelia abrotanoides']}'
Salvia abrotanoides	'{'pft': 'not assigned ()', 'originalNames': ['Perovskia abrotanoides']}'
Artemisia abrotanum	'{'pft': 'not assigned (shrub)', 'originalNames': ['Artemisia abrotanum']}'
Ipomoea abrupta	'{'pft': 'forb', 'originalNames': ['Ipomoea abrupta']}'
Eumachia abrupta	'{'pft': 'not assigned (shrub)', 'originalNames': ['Chazaliella abrupta']}'
Carex abscondita	'{'pft': 'grass', 'originalNames': ['Carex abscondita']}'
Crotalaria abscondita	'{'pft': 'not assigned (shrub)', 'originalNames': ['Crotalaria abscondita']}'
Chamaecytisus eriocarpus	'{'pft': 'not assigned (legume?)', 'originalNames': ['Chamaecytisus absinthioides']}'
Artemisia absinthium	'{'pft': 'not assigned (herb/shrub)', 'originalNames': ['Artemisia absinthium']}'
Ranunculus abstrusus	'{'pft': 'not assigned ()', 'originalNames': ['Ranunculus abstrusus']}'
Taraxacum absurdum	'{'pft': 'not assigned ()', 'originalNames': ['Taraxacum absurdum']}'
Cassia absus	'{'pft': 'not assigned (legume?)', 'originalNames': ['Cassia absus']}'
Chamaecrista absus	'{'pft': 'legume', 'originalNames': ['Chamaecrista absus']}'
Ionopsidium abulense	'{'pft': 'not assigned ()', 'originalNames': ['Ionopsidium abulense']}'
Trichoscypha oddonii	'{'pft': 'not assigned ()', 'originalNames': ['Trichoscypha abut']}'
Sida abutifolia	'{'pft': 'not assigned ()', 'originalNames': ['Sida abutifolia']}'
Ficus abutilifolia	'{'pft': 'not assigned (tree)', 'originalNames': ['Ficus abutilifolia']}'
Abutilon abutiloides	'{'pft': 'not assigned (herb/shrub)', 'originalNames': ['Abutilon abutiloides']}'
Phymosia abutiloides	'{'pft': 'not assigned ()', 'originalNames': ['Sphaeralcea abutiloides']}'
Heteromorpha arborescens	'{'pft': 'forb', 'originalNames': ['Heteromorpha abyssinica']}'
Astropanax abyssinicum	'{'pft': 'not assigned (tree)', 'originalNames': ['Schefflera abyssinica']}'
Stephanotis abyssinica	'{'pft': 'not assigned ()', 'originalNames': ['Dregea abyssinica']}'
Bulbine abyssinica	'{'pft': 'forb', 'originalNames': ['Bulbine abyssinica']}'
Guizotia abyssinica	'{'pft': 'forb', 'originalNames': ['Guizotia abyssinica']}'
Kleinia abyssinica	'{'pft': 'not assigned ()', 'originalNames': ['Kleinia abyssinica']}'
Cordia africana	'{'pft': 'not assigned (tree)', 'originalNames': ['Cordia abyssinica']}'
Crambe hispanica	'{'pft': 'forb', 'originalNames': ['Crambe abyssinica']}'
Wahlenbergia abyssinica	'{'pft': 'forb', 'originalNames': ['Wahlenbergia abyssinica']}'
Silene abyssinica	'{'pft': 'not assigned ()', 'originalNames': ['Uebelinia abyssinica']}'
Lagenaria abyssinica	'{'pft': 'not assigned ()', 'originalNames': ['Lagenaria abyssinica']}'
Dioscorea abyssinica	'{'pft': 'not assigned ()', 'originalNames': ['Dioscorea abyssinica']}'
Diospyros abyssinica	'{'pft': 'not assigned (tree)', 'originalNames': ['Diospyros abyssinica']}'
Clutia abyssinica	'{'pft': 'not assigned (shrub)', 'originalNames': ['Clutia abyssinica']}'
Cluytia	'{'pft': 'not assigned ()', 'originalNames': ['Cluytia abyssinica']}'
Euphorbia abyssinica	'{'pft': 'not assigned ()', 'originalNames': ['Euphorbia abyssinica']}'
Vachellia abyssinica	'{'pft': 'not assigned (tree)', 'originalNames': ['Acacia abyssinica']}'
Aeschynomene abyssinica	'{'pft': 'not assigned (herb/shrub)', 'originalNames': ['Aeschynomene abyssinica']}'
Antopetitia abyssinica	'{'pft': 'legume', 'originalNames': ['Antopetitia abyssinica']}'
Colutea abyssinica	'{'pft': 'not assigned (legume?)', 'originalNames': ['Colutea abyssinica']}'
Entada abyssinica	'{'pft': 'not assigned (tree)', 'originalNames': ['Entada abyssinica']}'
Erythrina abyssinica	'{'pft': 'not assigned (tree)', 'originalNames': ['Erythrina abyssinica']}'
Dovyalis abyssinica	'{'pft': 'not assigned (tree)', 'originalNames': ['Dovyalis abyssinica']}'
Swertia abyssinica	'{'pft': 'forb', 'originalNames': ['Swertia abyssinica']}'
Hydnora abyssinica	'{'pft': 'forb', 'originalNames': ['Hydnora abyssinica']}'
Cometes abyssinica	'{'pft': 'not assigned ()', 'originalNames': ['Cometes abyssinica']}'
Aristea abyssinica	'{'pft': 'forb', 'originalNames': ['Aristea abyssinica']}'
Turraea abyssinica	'{'pft': 'not assigned ()', 'originalNames': ['Turraea abyssinica']}'
Bersama abyssinica	'{'pft': 'not assigned (tree)', 'originalNames': ['Bersama abyssinica']}'
Stephania abyssinica	'{'pft': 'not assigned ()', 'originalNames': ['Stephania abyssinica']}'
Ludwigia abyssinica	'{'pft': 'forb', 'originalNames': ['Ludwigia abyssinica']}'
Peperomia abyssinica	'{'pft': 'forb', 'originalNames': ['Peperomia abyssinica']}'
Avena abyssinica	'{'pft': 'grass', 'originalNames': ['Avena abyssinica']}'
Digitaria abyssinica	'{'pft': 'grass', 'originalNames': ['Digitaria abyssinica']}'
Eragrostis abyssinica	'{'pft': 'grass', 'originalNames': ['Eragrostis abyssinica']}'
Exotheca abyssinica	'{'pft': 'grass', 'originalNames': ['Exotheca abyssinica']}'
Festuca abyssinica	'{'pft': 'grass', 'originalNames': ['Festuca abyssinica']}'
Oxytenanthera abyssinica	'{'pft': 'grass', 'originalNames': ['Oxytenanthera abyssinica']}'
Caylusea abyssinica	'{'pft': 'forb', 'originalNames': ['Caylusea abyssinica']}'
Ziziphus abyssinica	'{'pft': 'not assigned (shrub/tree)', 'originalNames': ['Ziziphus abyssinica']}'
Hagenia abyssinica	'{'pft': 'not assigned (tree)', 'originalNames': ['Hagenia abyssinica']}'
Pavetta abyssinica	'{'pft': 'not assigned ()', 'originalNames': ['Pavetta abyssinica']}'
Halleria lucida	'{'pft': 'not assigned ()', 'originalNames': ['Halleria abyssinica']}'
Hedbergia abyssinica	'{'pft': 'not assigned (herb/shrub)', 'originalNames': ['Hedbergia abyssinica']}'
Veronica abyssinica	'{'pft': 'forb', 'originalNames': ['Veronica abyssinica']}'
Selaginella goudotiana	'{'pft': 'not assigned (fern)', 'originalNames': ['Selaginella abyssinica']}'
Harrisonia abyssinica	'{'pft': 'not assigned (shrub/tree)', 'originalNames': ['Harrisonia abyssinica']}'
Viola abyssinica	'{'pft': 'forb', 'originalNames': ['Viola abyssinica']}'
Ampelocissus abyssinica	'{'pft': 'not assigned ()', 'originalNames': ['Ampelocissus abyssinica']}'
Delosperma abyssinicum	'{'pft': 'forb', 'originalNames': ['Delosperma abyssinicum']}'
Heracleum abyssinicum	'{'pft': 'forb', 'originalNames': ['Heracleum abyssinicum']}'
Cynanchum ethiopicum	'{'pft': 'not assigned ()', 'originalNames': ['Pentarrhinum abyssinicum']}'
Erucastrum abyssinicum	'{'pft': 'not assigned ()', 'originalNames': ['Erucastrum abyssinicum']}'
Jasminum abyssinicum	'{'pft': 'not assigned ()', 'originalNames': ['Jasminum abyssinicum']}'
Biophytum abyssinicum	'{'pft': 'forb', 'originalNames': ['Biophytum abyssinicum']}'
Andropogon abyssinicus	'{'pft': 'grass', 'originalNames': ['Andropogon abyssinicus']}'
Crinipes abyssinicus	'{'pft': 'grass', 'originalNames': ['Crinipes abyssinicus']}'
Rumex abyssinicus	'{'pft': 'forb', 'originalNames': ['Rumex abyssinicus']}'
Allophylus abyssinicus	'{'pft': 'not assigned (tree)', 'originalNames': ['Allophylus abyssinicus']}'
Plicosepalus acaciae	'{'pft': 'not assigned ()', 'originalNames': ['Loranthus acaciae']}'
Eucalyptus acaciiformis	'{'pft': 'not assigned (tree)', 'originalNames': ['Eucalyptus acaciaeformis', 'Eucalyptus acaciiformis']}'
Macrolobium acaciifolium	'{'pft': 'not assigned (tree)', 'originalNames': ['Macrolobium acaciifolium']}'
Melaleuca acacioides	'{'pft': 'not assigned (shrub/tree)', 'originalNames': ['Melaleuca acacioides']}'
Leptinella scariosa	'{'pft': 'forb', 'originalNames': ['Cotula acaenoides']}'
Liquidambar acalycina	'{'pft': 'not assigned ()', 'originalNames': ['Liquidambar acalycina']}'
Eragrostis acamptoclada	'{'pft': 'grass', 'originalNames': ['Eragrostis acamptoclada']}'
Festuca acamptophylla	'{'pft': 'grass', 'originalNames': ['Festuca acamptophylla']}'
Ambrosia acanthicarpa	'{'pft': 'forb', 'originalNames': ['Ambrosia acanthicarpa']}'
Carlina acanthifolia	'{'pft': 'not assigned ()', 'originalNames': ['Carlina acanthifolia']}'
Grevillea acanthifolia	'{'pft': 'not assigned ()', 'originalNames': ['Grevillea acanthifolia']}'
Onopordum acanthium	'{'pft': 'forb', 'originalNames': ['Onopordum acanthium']}'
Tetragonia acanthocarpa	'{'pft': 'not assigned (shrub)', 'originalNames': ['Tetragonia acanthocarpa']}'
Bactris acanthocarpa	'{'pft': 'not assigned (tree)', 'originalNames': ['Bactris acanthocarpa']}'
Cylindropuntia acanthocarpa	'{'pft': 'not assigned ()', 'originalNames': ['Opuntia acanthocarpa']}'
Atriplex acanthocarpa	'{'pft': 'not assigned (shrub)', 'originalNames': ['Atriplex acanthocarpa']}'
Ipomoea acanthocarpa	'{'pft': 'not assigned ()', 'originalNames': ['Ipomoea acanthocarpa']}'
Glycyrrhiza acanthocarpa	'{'pft': 'not assigned (legume?)', 'originalNames': ['Glycyrrhiza acanthocarpa']}'
Bactris acanthocarpoides	'{'pft': 'not assigned (tree)', 'originalNames': ['Bactris acanthocarpoides']}'
Sterigmostemum acanthocarpum	'{'pft': 'not assigned ()', 'originalNames': ['Sterigmostemum acanthocarpum']}'
Euonymus acanthocarpus	'{'pft': 'not assigned ()', 'originalNames': ['Euonymus acanthocarpus']}'
Gonocarpus acanthocarpus	'{'pft': 'not assigned ()', 'originalNames': ['Gonocarpus acanthocarpus']}'
Amaranthus acanthochiton	'{'pft': 'not assigned ()', 'originalNames': ['Amaranthus acanthochiton']}'
Acacia acanthoclada	'{'pft': 'not assigned (shrub)', 'originalNames': ['Acacia acanthoclada']}'
Genista acanthoclada	'{'pft': 'not assigned (shrub)', 'originalNames': ['Genista acanthoclada']}'
Pedleya acanthoclada	'{'pft': 'not assigned (legume?)', 'originalNames': ['Desmodium acanthocladum']}'
Trithrinax brasiliensis	'{'pft': 'not assigned ()', 'originalNames': ['Trithrinax acanthocoma']}'
Launaea acanthodes	'{'pft': 'not assigned ()', 'originalNames': ['Launaea acanthodes']}'
Ferocactus viridescens	'{'pft': 'not assigned ()', 'originalNames': ['Ferocactus acanthodes']}'
Rubus acanthodes	'{'pft': 'not assigned ()', 'originalNames': ['Rubus acanthodes']}'
Solanum vanheurckii	'{'pft': 'not assigned ()', 'originalNames': ['Solanum acanthodes']}'
Barleria acanthoides	'{'pft': 'forb', 'originalNames': ['Barleria acanthoides']}'
Carduus acanthoides	'{'pft': 'forb', 'originalNames': ['Carduus acanthoides']}'
Mimosa acantholoba	'{'pft': 'not assigned (legume?)', 'originalNames': ['Mimosa acantholoba']}'
Chondrilla juncea	'{'pft': 'not assigned ()', 'originalNames': ['Chondrilla acanthophylla']}'
Senegalia hayesii	'{'pft': 'not assigned (legume?)', 'originalNames': ['Acacia acanthophylla']}'
Festuca acanthophylla	'{'pft': 'grass', 'originalNames': ['Festuca acanthophylla']}'
Zanthoxylum acanthopodium	'{'pft': 'not assigned ()', 'originalNames': ['Zanthoxylum acanthopodium']}'
Euphorbia acanthothamnos	'{'pft': 'not assigned (shrub)', 'originalNames': ['Euphorbia acanthothamnos']}'
Lysiloma acapulcense	'{'pft': 'not assigned (legume?)', 'originalNames': ['Lysiloma acapulcense']}'
Wedelia acapulcensis	'{'pft': 'not assigned ()', 'originalNames': ['Wedelia acapulcensis']}'
Pterocarpus acapulcensis	'{'pft': 'not assigned (legume?)', 'originalNames': ['Pterocarpus acapulcensis']}'
Bronwenia acapulcensis	'{'pft': 'not assigned ()', 'originalNames': ['Banisteriopsis acapulcensis']}'
Eugenia acapulcensis	'{'pft': 'not assigned (tree)', 'originalNames': ['Eugenia acapulcensis']}'
Coccoloba acapulcensis	'{'pft': 'not assigned (shrub/tree)', 'originalNames': ['Coccoloba acapulcensis']}'
Trichilia micrantha	'{'pft': 'not assigned (shrub/tree)', 'originalNames': ['Trichilia acariaeantha']}'
Picnomon acarna	'{'pft': 'forb', 'originalNames': ['Cirsium acarna', 'Picnomon acarna']}'
Mariosousa acatlensis	'{'pft': 'not assigned (shrub/tree)', 'originalNames': ['Acacia acatlensis']}'
Havardia acatlensis	'{'pft': 'not assigned (legume?)', 'originalNames': ['Havardia acatlensis', 'Sphinga acatlensis']}'
Chamaesciadium acaule	'{'pft': 'forb', 'originalNames': ['Chamaesciadium acaule']}'
Cirsium acaule	'{'pft': 'forb', 'originalNames': ['Cirsium acaule', 'Cirsium acaulos']}'
Isostigma acaule	'{'pft': 'not assigned ()', 'originalNames': ['Isostigma acaule']}'
Ionopsidium acaule	'{'pft': 'not assigned ()', 'originalNames': ['Ionopsidium acaule']}'
Pelargonium acaule	'{'pft': 'not assigned ()', 'originalNames': ['Geranium acaule']}'
Acaulimalva acaulis	'{'pft': 'forb', 'originalNames': ['Malvastrum acaule']}'
Cypripedium acaule	'{'pft': 'forb', 'originalNames': ['Cypripedium acaule']}'
Solanum acaule	'{'pft': 'not assigned ()', 'originalNames': ['Solanum acaule']}'
Cymopterus glomeratus	'{'pft': 'forb', 'originalNames': ['Cymopterus acaulis']}'
Azorella acaulis	'{'pft': 'forb', 'originalNames': ['Huanaca acaulis']}'
Azorella ruizii	'{'pft': 'forb', 'originalNames': ['Laretia acaulis']}'
Geonoma macrostachys	'{'pft': 'not assigned (tree)', 'originalNames': ['Geonoma acaulis']}'
Anisocoma acaulis	'{'pft': 'forb', 'originalNames': ['Anisocoma acaulis']}'
Arctotis acaulis	'{'pft': 'forb', 'originalNames': ['Arctotis acaulis']}'
Carlina acaulis	'{'pft': 'forb', 'originalNames': ['Carlina acaulis']}'
Geigeria acaulis	'{'pft': 'not assigned ()', 'originalNames': ['Geigeria acaulis']}'
Hesperevax acaulis	'{'pft': 'forb', 'originalNames': ['Hesperevax acaulis']}'
Sonchus acaulis	'{'pft': 'not assigned ()', 'originalNames': ['Sonchus acaulis']}'
Stenotus acaulis	'{'pft': 'not assigned ()', 'originalNames': ['Stenotus acaulis']}'
Silene acaulis	'{'pft': 'forb', 'originalNames': ['Silene acaulis']}'
Faroa acaulis	'{'pft': 'forb', 'originalNames': ['Faroa acaulis']}'
Gentiana acaulis	'{'pft': 'forb', 'originalNames': ['Gentiana acaulis']}'
Swertia acaulis	'{'pft': 'forb', 'originalNames': ['Swertia acaulis']}'
Alcea acaulis	'{'pft': 'forb', 'originalNames': ['Alcea acaulis']}'
Cincinnobotrys acaulis	'{'pft': 'forb', 'originalNames': ['Haplophyllophora acaulis']}'
Oenothera acaulis	'{'pft': 'not assigned ()', 'originalNames': ['Oenothera acaulis']}'
Calandrinia acaulis	'{'pft': 'forb', 'originalNames': ['Calandrinia acaulis']}'
Primula vulgaris	'{'pft': 'forb', 'originalNames': ['Primula acaulis']}'
Potentilla acaulis	'{'pft': 'forb', 'originalNames': ['Potentilla acaulis']}'
Cirsium acaulon	'{'pft': 'not assigned ()', 'originalNames': ['Cirsium acaulon']}'
Onopordum acaulon	'{'pft': 'not assigned ()', 'originalNames': ['Onopordum acaulon']}'
Protea acaulos	'{'pft': 'not assigned (shrub)', 'originalNames': ['Protea acaulos']}'
Telosma accedens	'{'pft': 'not assigned ()', 'originalNames': ['Telosma accedens']}'
Litsea accedens	'{'pft': 'not assigned (tree)', 'originalNames': ['Litsea accedens']}'
Eucalyptus accedens	'{'pft': 'not assigned (tree)', 'originalNames': ['Eucalyptus accedens']}'
Calamagrostis frigida	'{'pft': 'grass', 'originalNames': ['Deyeuxia accedens']}'
Coussarea accedens	'{'pft': 'not assigned (tree)', 'originalNames': ['Coussarea accedens']}'
Litsea accedentoides	'{'pft': 'not assigned ()', 'originalNames': ['Litsea accedentoides']}'
Senna acclinis	'{'pft': 'not assigned (legume?)', 'originalNames': ['Senna acclinis']}'
Acacia adunca	'{'pft': 'not assigned (shrub/tree)', 'originalNames': ['Acacia accola']}'
Linzia accommodata	'{'pft': 'not assigned (herb/shrub)', 'originalNames': ['Vernonia accommodata']}'
Cyrtococcum accrescens	'{'pft': 'grass', 'originalNames': ['Cyrtococcum accrescens']}'
Rubus accrescens	'{'pft': 'not assigned (shrub)', 'originalNames': ['Rubus accrescens']}'
Schoutenia accrescens	'{'pft': 'not assigned ()', 'originalNames': ['Schoutenia accrescens']}'
Erigeron acer	'{'pft': 'forb', 'originalNames': ['Erigeron acer']}'
Grevillea acerata	'{'pft': 'not assigned ()', 'originalNames': ['Grevillea acerata']}'
Hovenia acerba	'{'pft': 'not assigned (tree)', 'originalNames': ['Hovenia acerba']}'
Omphacomeria acerba	'{'pft': 'not assigned ()', 'originalNames': ['Omphacomeria acerba']}'
Platanus hispanica	'{'pft': 'not assigned (tree)', 'originalNames': ['Platanus acerifolia']}'
Clematis acerifolia	'{'pft': 'not assigned (shrub)', 'originalNames': ['Clematis acerifolia']}'
Pterospermum acerifolium	'{'pft': 'not assigned (tree)', 'originalNames': ['Dombeya acerifolia', 'Pterospermum acerifolium']}'
Sterculia apetala	'{'pft': 'not assigned ()', 'originalNames': ['Sterculia acerifolia']}'
Viburnum acerifolium	'{'pft': 'not assigned (shrub)', 'originalNames': ['Viburnum acerifolium']}'
Pterocarpus acerifolius	'{'pft': 'not assigned (legume?)', 'originalNames': ['Pterocarpus acerifolium']}'
Brachychiton acerifolius	'{'pft': 'not assigned (varying)', 'originalNames': ['Brachychiton acerifolium', 'Brachychiton acerifolius']}'
Croton aceroides	'{'pft': 'not assigned (tree)', 'originalNames': ['Croton aceroides']}'
Heteropterys intermedia	'{'pft': 'not assigned ()', 'originalNames': ['Heteropterys aceroides']}'
Euphrosyne acerosa	'{'pft': 'not assigned ()', 'originalNames': ['Iva acerosa', 'Oxytenia acerosa']}'
Thymophylla acerosa	'{'pft': 'not assigned ()', 'originalNames': ['Thymophylla acerosa']}'
Zinnia acerosa	'{'pft': 'not assigned ()', 'originalNames': ['Zinnia acerosa']}'
Leptecophylla juniperina	'{'pft': 'not assigned ()', 'originalNames': ['Cyathodes acerosa']}'
Dracophyllum laciniatum	'{'pft': 'not assigned (shrub)', 'originalNames': ['Richea acerosa']}'
Melaleuca systena	'{'pft': 'not assigned (shrub)', 'originalNames': ['Melaleuca acerosa']}'
Distichlis acerosa	'{'pft': 'grass', 'originalNames': ['Monanthochloe acerosa', 'Monantochloe acerosa']}'
Persoonia acerosa	'{'pft': 'not assigned ()', 'originalNames': ['Persoonia acerosa']}'
Nenax acerosa	'{'pft': 'not assigned ()', 'originalNames': ['Nenax acerosa']}'
Hypericum laricifolium	'{'pft': 'not assigned ()', 'originalNames': ['Hypericum acerosum']}'
Dendrobium acerosum	'{'pft': 'forb', 'originalNames': ['Dendrobium acerosum']}'
Euphorbia acervata	'{'pft': 'not assigned (shrub)', 'originalNames': ['Euphorbia acervata']}'
Taraxacum acervatulum	'{'pft': 'not assigned ()', 'originalNames': ['Taraxacum acervatulum']}'
Pseudodictamnus acetabulosus	'{'pft': 'not assigned (shrub)', 'originalNames': ['Ballota acetabulosa']}'
Salvia africana	'{'pft': 'not assigned ()', 'originalNames': ['Salvia acetabulosa']}'
Rheum	'{'pft': 'forb', 'originalNames': ['Rheum acetosa']}'
Rumex acetosa	'{'pft': 'forb', 'originalNames': ['Rumex acetosa']}'
Ampelocissus acetosa	'{'pft': 'not assigned (shrub)', 'originalNames': ['Ampelocissus acetosa']}'
Microstachys acetosella	'{'pft': 'forb', 'originalNames': ['Sapium acetosella']}'
Hibiscus acetosella	'{'pft': 'not assigned (herb/shrub)', 'originalNames': ['Hibiscus acetosella']}'
Oxalis acetosella	'{'pft': 'forb', 'originalNames': ['Oxalis acetosella']}'
Rumex acetosella	'{'pft': 'forb', 'originalNames': ['Rumex acetosella']}'
Pelargonium acetosum	'{'pft': 'not assigned ()', 'originalNames': ['Pelargonium acetosum']}'
Calytrix achaeta	'{'pft': 'not assigned (shrub)', 'originalNames': ['Calytrix achaeta']}'
Stevia achalensis	'{'pft': 'forb', 'originalNames': ['Stevia achalensis']}'
Gentianella multicaulis	'{'pft': 'forb', 'originalNames': ['Gentiana achalensis']}'
Juncus pallescens	'{'pft': 'grass', 'originalNames': ['Juncus achalensis']}'
Aristida achalensis	'{'pft': 'grass', 'originalNames': ['Aristida achalensis']}'
Ixodia achillaeoides	'{'pft': 'not assigned ()', 'originalNames': ['Ixodia achillaeoides']}'
Gilia achilleifolia	'{'pft': 'not assigned ()', 'originalNames': ['Gilia achilleaefolia', 'Gilia achilleifolia']}'
Gigantochloa achmadii	'{'pft': 'grass', 'originalNames': ['Gigantochloa achmadii']}'
Myrsine achradifolia	'{'pft': 'not assigned ()', 'originalNames': ['Myrsine achradifolia', 'Rapanea achradifolia']}'
Festuca achtarovii	'{'pft': 'grass', 'originalNames': ['Festuca achtarovii']}'
Lantana achyranthifolia	'{'pft': 'not assigned ()', 'originalNames': ['Lantana achyranthifolia']}'
Cyathula achyranthoides	'{'pft': 'forb', 'originalNames': ['Cyathula achyranthoides']}'
Hypochoeris	'{'pft': 'forb', 'originalNames': ['Hypochoeris achyrophorus']}'
Dendrobium aciculare	'{'pft': 'forb', 'originalNames': ['Dendrobium aciculare']}'
Dichanthelium aciculare	'{'pft': 'grass', 'originalNames': ['Dichanthelium aciculare']}'
Carduus acicularis	'{'pft': 'not assigned ()', 'originalNames': ['Carduus acicularis']}'
Gnephosis acicularis	'{'pft': 'not assigned ()', 'originalNames': ['Gnephosis acicularis']}'
Opuntia	'{'pft': 'not assigned ()', 'originalNames': ['Opuntia acicularis']}'
Dianthus acicularis	'{'pft': 'forb', 'originalNames': ['Dianthus acicularis']}'
Eleocharis acicularis	'{'pft': 'grass', 'originalNames': ['Eleocharis acicularis']}'
Fimbristylis acicularis	'{'pft': 'grass', 'originalNames': ['Fimbristylis acicularis']}'
Hibbertia acicularis	'{'pft': 'not assigned ()', 'originalNames': ['Hibbertia acicularis']}'
Daviesia acicularis	'{'pft': 'not assigned (legume?)', 'originalNames': ['Daviesia acicularis']}'
Dillwynia acicularis	'{'pft': 'not assigned (legume?)', 'originalNames': ['Dillwynia acicularis']}'
Kunzea acicularis	'{'pft': 'not assigned (shrub)', 'originalNames': ['Kunzea acicularis']}'
Aciachne acicularis	'{'pft': 'grass', 'originalNames': ['Aciachne acicularis']}'
Chionochloa acicularis	'{'pft': 'grass', 'originalNames': ['Chionochloa acicularis']}'
Enteropogon acicularis	'{'pft': 'grass', 'originalNames': ['Chloris acicularis', 'Enteropogon acicularis']}'
Zotovia acicularis	'{'pft': 'grass', 'originalNames': ['Ehrharta acicularis']}'
Orites acicularis	'{'pft': 'not assigned ()', 'originalNames': ['Orites acicularis']}'
Rosa acicularis	'{'pft': 'not assigned (shrub)', 'originalNames': ['Rosa acicularis']}'
Neolitsea aciculata	'{'pft': 'not assigned ()', 'originalNames': ['Neolitsea aciculata']}'
Chrysopogon aciculatus	'{'pft': 'grass', 'originalNames': ['Chrysopogon aciculatus']}'
Podolobium aciculiferum	'{'pft': 'not assigned (legume?)', 'originalNames': ['Oxylobium aciculiferum', 'Podolobium aciculiferum']}'
Lannea acida	'{'pft': 'not assigned (tree)', 'originalNames': ['Lannea acida']}'
Gossia acmenoides	'{'pft': 'not assigned ()', 'originalNames': ['Gossia acmenoides']}'
Elaeocarpus acmocarpus	'{'pft': 'not assigned ()', 'originalNames': ['Elaeocarpus acmocarpus']}'
Salix acmophylla	'{'pft': 'not assigned ()', 'originalNames': ['Salix acmophylla']}'
Hypericum acmosepalum	'{'pft': 'not assigned ()', 'originalNames': ['Hypericum acmosepalum']}'
Acomis acoma	'{'pft': 'forb', 'originalNames': ['Acomis acoma']}'
Corybas aconitiflorus	'{'pft': 'forb', 'originalNames': ['Corybas aconitiflorus']}'
Ampelopsis aconitifolia	'{'pft': 'not assigned (shrub)', 'originalNames': ['Ampelopsis aconitifolia']}'
Cnidoscolus aconitifolius	'{'pft': 'not assigned ()', 'originalNames': ['Cnidoscolus aconitifolius']}'
Vigna aconitifolia	'{'pft': 'not assigned (legume?)', 'originalNames': ['Phaseolus aconitifolius']}'
Ranunculus aconitifolius	'{'pft': 'forb', 'originalNames': ['Ranunculus aconitifolius']}'
Disa aconitoides	'{'pft': 'forb', 'originalNames': ['Disa aconitoides']}'
Helmholtzia acorifolia	'{'pft': 'forb', 'originalNames': ['Helmholtzia acorifolia']}'
Forsteronia acouci	'{'pft': 'not assigned ()', 'originalNames': ['Forsteronia acouci']}'
Isocoma acradenia	'{'pft': 'not assigned (varying)', 'originalNames': ['Isocoma acradenia', 'Haplopappus acradenius']}'
Acacia acradenia	'{'pft': 'not assigned (shrub/tree)', 'originalNames': ['Acacia acradenia']}'
Eragrostis acraea	'{'pft': 'grass', 'originalNames': ['Eragrostis acraea']}'
Myrsine acrantha	'{'pft': 'not assigned ()', 'originalNames': ['Myrsine acrantha', 'Rapanea acrantha']}'
Erythroxylum platyclados	'{'pft': 'not assigned ()', 'originalNames': ['Erythroxylum acranthum']}'
Sedum acre	'{'pft': 'forb', 'originalNames': ['Sedum acre']}'
Tapura acreana	'{'pft': 'not assigned (tree)', 'originalNames': ['Tapura acreana']}'
Inga acreana	'{'pft': 'not assigned (tree)', 'originalNames': ['Inga acreana']}'
Gouania acreana	'{'pft': 'not assigned ()', 'originalNames': ['Gouania acreana']}'
Stenostomum acreanum	'{'pft': 'not assigned ()', 'originalNames': ['Guettarda acreana', 'Stenostomum acreanum']}'
Calycophyllum megistocaulum	'{'pft': 'not assigned (tree)', 'originalNames': ['Calycophyllum acreanum']}'
Zanthoxylum acuminatum	'{'pft': 'not assigned (tree)', 'originalNames': ['Zanthoxylum acreanum']}'
Costus acreanus	'{'pft': 'forb', 'originalNames': ['Costus acreanus']}'
Eugenia acrensis	'{'pft': 'not assigned ()', 'originalNames': ['Eugenia acrensis']}'
Acacia acrionastes	'{'pft': 'not assigned (tree)', 'originalNames': ['Acacia acrionastes']}'
Erigeron acris	'{'pft': 'forb', 'originalNames': ['Erigeron acris']}'
Diplotaxis acris	'{'pft': 'not assigned ()', 'originalNames': ['Diplotaxis acris']}'
Pimenta racemosa	'{'pft': 'not assigned ()', 'originalNames': ['Pimenta acris']}'
Ranunculus acris	'{'pft': 'forb', 'originalNames': ['Ranunculus acris']}'
Serruria acrocarpa	'{'pft': 'not assigned ()', 'originalNames': ['Serruria acrocarpa']}'
Vernonella acrocephala	'{'pft': 'forb', 'originalNames': ['Vernonia acrocephala']}'
Inga acrocephala	'{'pft': 'not assigned (tree)', 'originalNames': ['Inga acrocephala']}'
Cayratia acris	'{'pft': 'not assigned (shrub)', 'originalNames': ['Cayratia acris']}'
